F      20,20,20

C      0,30,200

  NO textures/wolfenstein/blue_stone.xpm              

    EA textures/wolfenstein/blue_stone.xpm
        WE         textures/wolfenstein/blue_stone.xpm







  SO textures/wolfenstein/ blue_stone.xpm

    111111111111111111111111111111111111111111111111111111111111111111111111111111111111111111111111111111111111111111111111111111111111111111111111111111111111111111111111111111111111111111111111111111111111111111
11111100000000000000000000000000000000000000000000000000000000000000000000000000000000000000000000000000000000000000E11
111111111111111111111111111111111111111111111111111111111111111111111111111111111111111111111111111111111111111111111111111111111111111111111111111111111111111111111111111111111111111111111111111111111111111111
