F      20,20,20

C      50,50,255

  NO textures/wolfenstein/blue_stone.xpm 

    EA textures/wolfenstein/blue_stone.xpm
        WE         textures/wolfenstein/blue_stone.xpm

  SO textures/wolfenstein/blue_stone.xpm







    111111111111111
111111000001E11
111111111111111