     11111111111
1000000000000001
1000000000000001
1000000000000001
1000000000111111
10000N00001
10000000001
10000000001
10000000001
10000000001
10000000001
11111111111
