F      255,100,111

C      0,100,255

NO    ./textures/wolfenstein/blue_stone.xpm

EA ./textures/wolfenstein/blue_stone.xpm
WE ./textures/wolfenstein/blue_stone.xpm

SO ./textures/wolfenstein/blue_stone.xpm

      11111111111111111
1111110000000001
1000000000000001
1000000000000001
1000000000111111
10000N00001
10000000001
10000000001
10000000001
10000000001
10000000001
11111111111