F      20,20,20
C      0,30,200


  NO textures/wolfenstein/blue_stone.xpm              

    EA textures/wolfenstein/blue_stone.xpm
        WE         textures/wolfenstein/blue_stone.xpm







  SO textures/wolfenstein/blue_stone.xpm

    111111111111111111111111111111111111111111111111111111111111111111111111111111111111111111111111111111111111111111111111111111111111111111111111111111111111111111111111111111111111111111111111111111111111111111
111111000000000000000000000000000000000000000000000000000000000000000000000000000000000000000000000000000000000000011
111111000000000000000000000000000000000000000000000000000000000000000000000000000000000000000000000000000000000000S11
111111111111111111111111111111111111111111111111111111111111111111111111111111111111111111111111111111111111111111111111111111111111111111111111111111111111111111111111111111111111111111111111111111111111111111
