F      20,20,20

C      50,50,255
NO    ./textures/wolfenstein/blue_stone.xpm

    EA ./textures/wolfenstein/blue_stone.xpm
WE    ./textures/wolfenstein/blue_stone.xpm

  SO ./textures/wolfenstein/blue_stone.xpm





  
      11111111111111111
1111111000000001
1110000000000001111
   10000000000000001
1111E00001111111111
10000000001
1000000001
10000000001
10000000001
10000000001
10000000001
11111111111